################################################## ##### ############################################
#     #                           #                                                                 #
# ##### ### ####### ### ##### ### # ##### ### ###                                                   #
#       # # #   #   # # #   #   #       #   # #                                                     #
# ### ### # ### # ### ### ### ### ### # ### # # #                                                   #
# # # #   #   # # # #     #   #   # #     # # # #                                                   #
# # ### ####### ### # ### # ### ### ##### # # ###  #                                                #
# #                   # # # #     # #   # # #                                                       #
# ############### ##### ### # ##### # ### ### #####                                                 #
#           #   # #         # #     # # #   # #   # #                                               #
# ### ### # # ### # ######### # ### # # # ### # ###                                                 #
# # #   # # #     #       #   # # #   # # #   #                                                     #
# # ####### ### # ##### ### ### # # ### # # # #####                                                 #
#             # #     # #   #     # #   #   #                                                       #
# ##### # ### # ##### ### ##### ### # ### ### #####                                                 #
# #   # # #   # #           # # #   # #   #       #                                                 #
# # ### # ### # # ### ### ### ### ### ### # #######                                                 #
#   #       # # # # #   # #   #   #       # #       #                                               #
# ########### # # # # ### ### ### # ####### # ##### #                                               #
# #           #   # # # #   #   #   #         #                                                     #
# ### ####### ### # # # # # # ### ##### ##### ########                                              #
#   # #     #   # # # #   #   #   #     #   # #                                                     #
# ### # ##### ### # # ##### ##### # ### # # # # ### ##                                              #
# #   # # #   #   # #     #       # # #   # #   #   #                                               #
# ##### # ### # ### ##### ### ##### # ### # ### # ###                                               #
#       #   # # #       #     #       # #     # # #                                                 #
# ### ##### ### # ##### # ### ### ##### # ### ### # ##                                              #
# # #     #     #   # # # # #   # #     # #         #                                                
# # # ##### ### ### # # # # ##### # ### # # ####### #                                               #
# #   #     # #   # # # # #       # #   # # # #   # #                                               #
# # ### ### # ##### # # # # ##### # ### # ### ### # ##                                               
# # #   # #         #   # # #   # #   # #       #                                                   #
# # # ### ####### ### ### ##### ### ### ### ### ######                                              #
# # #   #             #                     # #                                                      
# # ### ##### ####### ### ############# ##### ### ###                                               #
# #   #     # #         #               #       # #                                                 #
# ### ### ### ### ##### ##### ### ##### # ####### ####                                              #
#   #   #       # #   #     #   # # # # # # #                                                        
# # # # ### ##### ### # ### ### # # # # # # # # ######                                              #
# # # #   # #       # # # # # # #   # # # # # # #                                                   #
# ### ### # # ##### # ### # # ##### # ### # # #######                                                
#         #   # #   #             # #     # # #     #                                                
# ##### # ##### # ### ##### ### ### # # ### # ##### #                                               #
# #   # #       # #   #     # #     # # #         # #                                               #
# # # # ### ##### ### ### ### # ### ### ### ####### #                                               #
# # # #   # #       #   # #     # #       # #                                                       #
# # # ### ### # ##### ### ####### ######### ### ######                                              #
# # #   #       #     #   #           #       # #                                                   #
# # # ### # ##### ##### # # ### ### ### ####### # ####                                              #
# # # #   # #     #     # # #   # #     #       #                                                    
# ### ##### ### ### ### ### ### # # ##### ###########                                                
#             # #   # #       #     #     #       #                                                 #
########### # # ##### ### ##### ######### ### ### ###                                                
#         # # #     #   # #     #       #     # #   #                                               #
# ####### ### # ### # ### # ### # # ### # ##### ### ##                                              #
# #   # #     # # # # #     # # # # # # # #       #                                                  
# # ### ##### # # ### ####### # ### # ### ##### # ###                                                
#   # #     # #       #       #     #         # #   #                                               #
# ### ##### # ### ### ### ### # ############# # ### #                                               #
# #       #     # # #   #     #             # #   # #                                               #
# # ##### # ### # # # # # ### ##### ####### # ### # #                                               #
# # #   #   # # # # # # # # #     # # #     #   # # #                                               #
# ### ### ### ### # # # # # # ### # # # ### # ### # #                                               #
#     # # #         # # # #   # #   # # # #   #   # #                                               #
# ##### # # # ####### # ### ### ##### ### ##### # # #                                               #
# #       # # #       # #   # #           #     # # #                                               #
# # ##### ### ### ##### ### # ##### ##### # ### # ###                                               #
# #     #   #         #     #     #     # #   # #                                                   #
# ##### ### # ### ### # ### # # ### ### # ##### ######                                              #
#     # #   #     # #   # # # # #   # # #                                                           #
# ##### ##### ### # ### # # # ### ### # ######### # ##                                              #
# #       #   # # #   # # # #     #   #     #   # # #                                               #
# ### # ### ### ### # ### # ### ### # # ##### # # # #                                               #
#   # # #           #     #   # #   # # #     # # # #                                               #
# ### # # ####### ### ### # # ### # # ####### # ### #                                               #
# #   # # #     # # # # # # #     #         # #     #                                               #
# # ### ### ##### # ### ### ### ### ######### ### # #                                               #
# # #       #     #             #   #     #     # # #                                                
# # ####### # ### # ### ####### ### # ### # ### ### ##                                              #
# #         # # # # # # #     #   #   # #   #                                                       #
# # ######### # # ### # # ### ### ### # # ####### ###                                               #
# # #     #   # #     # # #     #   # # # #       # #                                               #
# ### ### ### # ### ### # ##### # ### # # # ##### # #                                               #
#       #     #   # #   #     # # # #   # # #   # # #                                               #
# ### ##### # ### # ### # ### ### # ### # ### # ### ##                                              #
# # # #   # #     #     # # #         # #     #                                                     #
# # ### ### # ##### # ### # ######### # ### # #######                                               #
# #     #     #     # #   #         # #   #                                                         #
# ### ### # ### ##### # ### ##### # ##### ### ### ###                                               #
#   #     # #         # #   #   #           # #   # #                                               #
# ### ##### # ######### ### ### ####### ### # ### # ##                                              #
# #   #     # #           #   #       # # #     # #   #                                             #
# # # # ##### ### ### # # ##### # ##### # # ### ### ###                                             #
# #     #       # # # # #   #   # #       # #       #                                               #
# ##### # ### ### # ### ### ### ### ##### # # ##### ####                                            #
#     # #     #   #   # # #   # #   #   # # # #   #                                                 #
# ##### # ### # ### ### # # ### ### # ### ### # # #####                                             #
# #     # # # # #         # #     # # #       # #     #                                              
# ##### ### ### ########### ##### ### ######### ##### #                                              
#                                                                                                   #
#################################################################### ############### ################
