################################################## ##### ############################################
#     #                           #                                                                 #
# ##### ### ####### ### ##### ### # ##### ### ###                         #######################   #
#       # # #   #   # # #   #   #       #   # #                           #                     ##  #
# ### ### # ### # ### ### ### ### ### # ### # # #                        ##                      #  #
# # # #   #   # # # #     #   #   # #     # # # #                                                #  #
# # ### ####### ### # ### # ### ### ##### # # ###  #                     #                       #  #
# #                   # # # #     # #   # # #                            #            ######### ##  #
# ############### ##### ### # ##### # ### ### #####                      #  ##########           #  #
#           #   # #         # #     # # #   # #   # #                   #####     ## ##          #  #
# ### ### # # ### # ######### # ### # # # ### # ###                     #            x           #  #
# # #   # # #     #       #   # # #   # # #   #                         #        ##    #         #  #
# # ####### ### # ##### ### ### # # ### # # # #####                     #        ###   #      ####  #
#             # #     # #   #     # #   #   #                           ###        ############  #  #
# ##### # ### # ##### ### ##### ### # ### ### #####                     #  ##########            #  #
# #   # # #   # #           # # #   # #   #       #                     #                        #  #
# # ### # ### # # ### ### ### ### ### ### # #######                     #                        #  #
#   #       # # # # #   # #   #   #       # #       #                  #                         #  #
# ########### # # # # ### ### ### # ####### # ##### #                  #                         #  #
# #           #   # # # #   #   #   #         #                        #                        ##  #
# ### ####### ### # # # # # # ### ##### ##### ########                ##                 # #####    #
#   # #     #   # # # #   #   #   #     #   # #                       ####################          #
# ### # ##### ### # # ##### ##### # ### # # # # ### ##                #                             #
# #   # # #   #   # #     #       # # #   # #   #   #                 #                             #
# ##### # ### # ### ##### ### ##### # ### # ### # ###                 #                             #
#       #   # # #       #     #       # #     # # #                  #                              #
# ### ##### ### # ##### # ### ### ##### # ### ### # ##               #                              #
# # #     #     #   # # # # #   # #     # #         #                #                               
# # # ##### ### ### # # # # ##### # ### # # ####### #                #                              #
# #   #     # #   # # # # #       # #   # # # #   # #                #                              #
# # ### ### # ##### # # # # ##### # ### # ### ### # ##              ##                               
# # #   # #         #   # # #   # #   # #       #                   #                               #
# # # ### ####### ### ### ##### ### ### ### ### ######                                              #
# # #   #             #                     # #                     #                                
# # ### ##### ####### ### ############# ##### ### ###               #                               #
# #   #     # #         #               #       # #                                                 #
# ### ### ### ### ##### ##### ### ##### # ####### ####              #                               #
#   #   #       # #   #     #   # # # # # # #                       #                                
# # # # ### ##### ### # ### ### # # # # # # # # ######              #                               #
# # # #   # #       # # # # # # #   # # # # # # #                   #                               #
# ### ### # # ##### # ### # # ##### # ### # # #######               #                                
#         #   # #   #             # #     # # #     #               #                                
# ##### # ##### # ### ##### ### ### # # ### # ##### #               #                               #
# #   # #       # #   #     # #     # # #         # #               #                               #
# # # # ### ##### ### ### ### # ### ### ### ####### #               #                               #
# # # #   # #       #   # #     # #       # #                       #                               #
# # # ### ### # ##### ### ####### ######### ### ######               #                              #
# # #   #       #     #   #           #       # #                    #                              #
# # # ### # ##### ##### # # ### ### ### ####### # ####               #                              #
# # # #   # #     #     # # #   # #     #       #                    #                               
# ### ##### ### ### ### ### ### # # ##### ###########                 #                              
#             # #   # #       #     #     #       #                   #                             #
########### # # ##### ### ##### ######### ### ### ###                 #                              
#         # # #     #   # #     #       #     # #   #                  #                            #
# ####### ### # ### # ### # ### # # ### # ##### ### ##                 #                            #
# #   # #     # # # # #     # # # # # # # #       #                    #                             
# # ### ##### # # ### ####### # ### # ### ##### # ###                  #                             
#   # #     # #       #       #     #         # #   #                   #                           #
# ### ##### # ### ### ### ### # ############# # ### #                   #                           #
# #       #     # # #   #     #             # #   # #                                               #
# # ##### # ### # # # # # ### ##### ####### # ### # #                   #                           #
# # #   #   # # # # # # # # #     # # #     #   # # #                                               #
# ### ### ### ### # # # # # # ### # # # ### # ### # #                    #                          #
#     # # #         # # # #   # #   # # # #   #   # #                    #                          #
# ##### # # # ####### # ### ### ##### ### ##### # # #                    #                          #
# #       # # #       # #   # #           #     # # #                    #                          #
# # ##### ### ### ##### ### # ##### ##### # ### # ###                    #                          #
# #     #   #         #     #     #     # #   # #                        #                          #
# ##### ### # ### ### # ### # # ### ### # ##### ######                   #                          #
#     # #   #     # #   # # # # #   # # #                                #                          #
# ##### ##### ### # ### # # # ### ### # ######### # ##                   #                          #
# #       #   # # #   # # # #     #   #     #   # # #                    #                          #
# ### # ### ### ### # ### # ### ### # # ##### # # # #                    #                          #
#   # # #           #     #   # #   # # #     # # # #                    #                          #
# ### # # ####### ### ### # # ### # # ####### # ### #                    #                          #
# #   # # #     # # # # # # #     #         # #     #                    #                          #
# # ### ### ##### # ### ### ### ### ######### ### # #                    #                          #
# # #       #     #             #   #     #     # # #                    #                           
# # ####### # ### # ### ####### ### # ### # ### ### ##                   #                          #
# #         # # # # # # #     #   #   # #   #                            #                          #
# # ######### # # ### # # ### ### ### # # ####### ###                    #                          #
# # #     #   # #     # # #     #   # # # #       # #                    #                          #
# ### ### ### # ### ### # ##### # ### # # # ##### # #                    #                          #
#       #     #   # #   #     # # # #   # # #   # # #                    #                          #
# ### ##### # ### # ### # ### ### # ### # ### # ### ##                   #                          #
# # # #   # #     #     # # #         # #     #                           #                         #
# # ### ### # ##### # ### # ######### # ### # #######                     #                         #
# #     #     #     # #   #         # #   #                               #                         #
# ### ### # ### ##### # ### ##### # ##### ### ### ###                     #                         #
#   #     # #         # #   #   #           # #   # #                     #                         #
# ### ##### # ######### ### ### ####### ### # ### # ##                     #                        #
# #   #     # #           #   #       # # #     # #   #                    #                        #
# # # # ##### ### ### # # ##### # ##### # # ### ### ###                   ##                        #
# #     #       # # # # #   #   # #       # #       #                      #                        #
# ##### # ### ### # ### ### ### ### ##### # # ##### ####                  ##                        #
#     # #     #   #   # # #   # #   #   # # # #   #                       ##                        #
# ##### # ### # ### ### # # ### ### # ### ### # # #####                    #                        #
# #     # # # # #         # #     # # #       # #     #                    #                         
# 0#### ### ### ########### ##### ### ######### ##### #                    #                         
#                                                                         ##                        #
#################################################################### ############### ################
