#############################################
# 0 #               #   #                   #
#   #   #   #####   #   #   #############   #
#       #       #       #   #       #       #
#   #########   #########   #   #   #   #####
#           #           #   #   #   #   #   #
#   #################   #####   #   #   #   #
#   #           #       #       #       #   #
#   #   #####   #   #   #   #############   #
#   #   #           #   #       #           #
#   #   #####################   #####   #   #
#   #   #                   #           #   #
#####   #   #############   ########## ##   #
#       #   #           #               #  x#
#   #####   #########   #####################
#                                           #
#############################################