#####################################################################################################
#0                                                                #                                 #
# ### ### ### ### ### ######### ####### # ### ########### ### ### # ##### ##### ### ####### ##### # #
# # # # #   # # # # # #       # #     # # # # #         #   #     #     # # # # # # #     # #   # # #
# # # # ### # # ### # # ### ### ### ### ### ### ##### # ### ### ### ##### # # # # # # ##### ### ### #
# # # #   #   #       # # # #                   #   # #   #   # #   #     # # #   # # #       #     #
# # ### # ########### # # # ############### ##### ### # ### # # ### # ##### # ##### # ### # ### # # #
# #         #       # #   #               # #     # #       # #   # # #     #       #   # # #   # # #
# ### # ### ### ##### ### # ####### # ####### ##### # ####### # ### ### ### ### ##### # # # ### ### #
#   # # # #     # #     # # #     # # #       #       # #   # #   # #         # #     # # # # #     #
### ### # ### ### ##### # # ##### # ### ##### ### ##### # ### # # ### ####### # ##### # ### # # ### #
# #     #   # #       # #     #   #     # #       #       #   # #     #     # #     # #     # #     #
# # ### # ### ### ### # ### ### # ####### ######### ##### ### # ##### # ### ### ##### ### ### ##### #
# # # # #       # # # #   # #   #     # #                   # #       # #   #   #       #         # #
# ### # ### ##### # # ### ### # ##### # ### ####### ######### ####### # ### ### ### ##### ####### # #
#     #   # #       #         #     #       #     # #     #         # #       #   # #   # #     # # #
# ### # ### # ##### ### ######### # # ##### # ### # ### # ### ### ### ##### ### ### ### # # ### ### #
# # # #   # # #   #   # #       # # # #   # # # # #   # #     #   #       #     #         # # #     #
# # # ### # # ### ### # ##### ### # # ### ### # # # ### # ##### # # ### # # ### ##### ####### ### # #
# # #   # #     #   #       # #   # #   #     # #   #           #   # # # # # #     # #         # # #
# # # ### ### ### # ######### # ### # # ##### # # ### ######### ##### ### # # ##### # ### ##### ### #
# # # #     # #   #           # #   # #   #   # # #     #     #       #   #       # #   # #       # #
# # # ##### # # ### ### ##### ##### # # ### ### ### ##### # # ### ### # ### ##### # # ##### ##### # #
# #   #   # # # #   # # #   #     # #   #   #             #     # # # # #   #   # # # #         # # #
# ### ### ### ### ### # # # ##### ### # ### ######### ### ### # ### ### # ##### # # # # ######### # #
#       #         #   # # #     #     #   #         # # #   # #         # #     # # # # #         # #
# ### ### ######### # ### ##### # ##### ########### # # # ### # ####### # ##### # # # # ##### ### # #
# #         #     # #       # # #       #         # # # # #     # #     #     # # #   #   #     #   #
# # ### ##### ##### ######### # ##### # ### ####### ### # ### ### ### ####### # # # ### # # ### ### #
# # # # #     #                   # # #   #             # #   #     # #       # # # #   # # #     # #
# ### # # ##### ### ##### ##### ### ##### # ############# ##### ##### ### ##### ### ### # # ##### # #
#     # #       # # #   # #     #   #     # #                         # # #           # # #     # # #
# ##### ### # ### ### ### # ### ### # ##### ##### ### ############# ### # ##### ### # ### # ### ### #
# #       #   #           # # #     # #       # # # # #           #     #   #   # # #     # # #     #
# # ##### # ### ##### ##### # ####### ######### # # ### ### # ### ### # # # ##### # # ##### # ### ###
# # #   # # #     # # #     #                   # #     # #   # #   # # # #       # # #     #     # #
# # ### # ### ### # # ####### ########### # # # ### ##### ##### ### # # # ######### # ### ####### # #
# # # #         # # #         #         # # # #                 # # # # # #         #   # #     # # #
# # # ### ##### # # # ### ### ##### # ### # ########### ######### # # # # # # ##### ##### ##### # # #
#   # # # #   #   # # # #   #     # #     #         #   #           # # # # # #   #             # # #
# ### # ### ### ### # # ##### # ### ##### ##### ### ### # ### ####### # ### # ### # ########### # # #
# #   #     #   #   # #       # # #     # #   # # #   #   # # #             #   # #           #   # #
# # ### ### ### # # # ### ### ### ####### ### # # ### ### # ### ######### # # ### ### ### ### # ### #
# #     # # # # # # #   #   #                 # # # #   # #             # # # #     # # # # # # #   #
# # ### # ### # ### # ### # ####### ########### # # ### # # ####### ##### ### ##### ### # # ### ### #
# # # # #     #     # #   #         #     #     # #   # # # #     # #   #   #           #   #     # #
# ### # # ### # ### # # # ### ####### ### # # ### ### # # # # ### ### # # ### ##### ### ##### ##### #
#     # #     #     # # #   # #       # # # # #     # # # # #         # # #   #   #   #       #     #
# ### # ##### ##### # ### # ##### ##### # # # # ### # ### # ####### ##### # ### ### # # # ### # ### #
# # # #     #       #   # #     # #     # # # # # #       #       #       # #   # # # # # # # # #   #
# # ### ### # ##### # ### # # ### # ### # # ##### ##### ### ##### ####### # ### # ### # ### # # ### #
# #     #   #   # # # # # # # # # # # # # #           # #       #       #       #   #       #   # # #
# ### ########### ### # ### # # # # # # # ### ##### # # # ### ### ####### ##### ### ####### ### # # #
#   #                 #     # # # #   # #   # #   # # # # # # #   #       #   #   #     #     #   # #
# ### ############# # # ##### # # ##### ### # ### ### ### # ### ########### ### ### ### ##### # ### #
# # # #       #   #   # # #   #           #     #   #       #               #   #   # #       # #   #
# # # ### ### # # ##### # ### ######### ##### ### # # ##### ####### ##### # ### # # # ####### ### # #
# # #   # # # # #       #   #         #     # #     #     #       # #   #     # # # #       #     # #
# # ### ### # # ### ### ### ##### ##### ### # ##### # ### # ### ### #   ##### # # ### # ### ### ### #
# #           # # # #     # #   # #     # # #     #   # # # # #     #       # # # #   # # #   #     #
# # ########### # ### ### # ### # # ##### # ### # ### # # ### ##### ### ##### ### ##### # ### ##### #
# # #                 # # #     # # #   # #   # # # # #   #       #   #     #   #   # #   #       # #
# # ######### ####### # ### ##### ### ### # ### ### # # ### # ##### # ##### ### ### # ### ######### #
# #         # #     # #   # #         #   # #       # # #   # #           #       # #   #           #
# # ####### # # # ### # ### ### ####### ### # ### # ### ### # ### ### # ### ##### # ### # ### ### ###
# # #     # # #   #   # #     #         # # # # # #       #     #   # # #   #   # #     # #   # # # #
# ####### # # ### # # # ##### ### ####### # ### # # # ##### ##### ### # # ### ### ######### ### # # #
#   #   # # #   # # # #                         # #   #     #     #   # # #   #             #   # # #
# ### ### # # ### ### ################# ####### # ### # ### ##### ### # # # # ########### ### # # # #
# #   #     # #                         #     # #   # #   #     #   #     # #           # #   # # # #
# # ### ##### # ################# ### ### ### ### # # ### ### # ### # ### # ### ####### # # ### # # #
# # #   #       #               #   # #   # #     # #   #   # #   # #   # #   # #       # # #   # # #
# # ##### ##### # ######### ##### ### # ### # ### ### ### ### # # ######### ### ##### # # ### ### # #
# #           # # #       #   #       #     #   # # # #       # #       #   #       # # #     #   # #
# ##### ### ### ######### ### ####### ##### ### ### # # ### ### ##### # # # ##### ##### # ### ##### #
#     # # # #               #       #     #   #     # #   # #       # # # #     # #     # # #       #
# ### ### ####### ##### ##### ##### ### ##### ### ### ##### ######### # # # ### # # ### # # # ##### #
#               # #   # #         #         #   # #                 # # # # #   #   # # # # #     # #
# ### # ######### ### ### ### # ### ### ##### ### # ### # ######### ### # # ##### ### # # # ####### #
# # # # #           #   #   # #   # # #       #   #     # #           # # #       #   # # #         #
# # ### # ### ####### ### ### ##### # # ##### ##### ### ### ####### ### ####### ### ##### x###### # #
# #   #   # # #   #       #         # # #           # #   # # #   #             #               # # #
# ### ### # ### ### ####### ### # ### ### ######### # # ### # # ### # ########### ### ######### ### #
# #     # #     #   #           # #     # #       # #   # # # # #   # #           #           # #   #
# # ##### ##### # # # ####### # ### ##### ### ### ##### # # # # ### # ### ### ### # # ##### # # # # #
#   #         # #   # #     # #     #       # # #     #   # # #     #   #   #   # # # #   # # # # # #
# ### ######### ##### ### # # # ##### ####### # # ### # ### # ####### # ##### ### ### # ### # # ### #
# #   # #               # #   # #               # # # # #             #       #       # #     #     #
# # ### # ##### ####### # ##### # ### ### ####### # ### ##### ### ### # ##### # ##### # ##### ### # #
# # #     #   #       # #   #   #   # # # #           #     # # #   # # #   #   #     #     #   # # #
# # # ### ### ### ### # ### ### ##### # # ##### ##### # ##### # ##### # ### ### # # ### # ### ##### #
# # # #     #   # # #     #   #     #   #     # #   # # #     #     #         # #   #     #         #
# # # # ### # ##### # ### ### # ### ##### # ##### # ### # ##### ##### ### ##### # ### # ### ### ### #
# # #   # # #       # #   # #   # # #     # # #   #     # #           # # #     # #   # #   # # # # #
# # ##### ### ##### ##### # ##### # # ### ### # ##### # # ### # ##### # ### ### # ### ### ### ### # #
# #     #               #     #   # # #       #     # # #   # # #   # #     # # #   #   #         # #
# ####### ##### ### ### ##### # # ### # ##### ### ### # ### # # ### # # ##### ##### # # ### # ##### #
# #       #   # # # #       # # #     # #   #   #         # # #   # #     #         # #   # # # #   #
# # ##### ### ### # ######### ######### ### # ############# # # ### # ####### ####### ##### ### ### #
#   #                                                         #       #                           # #
#####################################################################################################
