#####################################################################################################
#   0                             #                                                                 #
# # ##### ### ####### # ####### # # ##### ####### # # ####### ### ######### # ########### ### # ### #
# # #     # # #     # # #     # # # #     #     # # # #     #   # #   #   #   #   #     # #   # # # #
##### ##### # # ### # # # ##### ### ##### ### ### # # # ### ### ### # # ### ### # ### ### ### ### # #
#     #     # # # # # # # #     #   #   #         #   # # #   #     #   #   #   #     #     # # #   #
# # # # ### ### # # ### # ##### # ### # # ### ### # ### # ### # ### # ### ###   ####### ### # # ### #
# # # # # #           # #     # # #   # #   # # # # #   #   # # # # # #   #     # #       # # #     #
# # # # # ########### # # ##### # ##### ### # # # ### ### # ### # # ### # # ##### ### ### ### # ### #
# # # # #           # #   #     #   # #   # # #       #   #     # #     # # #       # # #     # # # #
# # ### ########### # ### # ### # # # ### # ### ### ### ### ##### ####### # ### ### ### ##### # # # #
#   #             #   # # # #   # # #         # # #     # #               #   # # #   #     #   # # #
# ### ### ### ### ### # ### # ### # ##### ### # # ##### # ############### # ### # ####### ### ### # #
# #   #       # #   #       # #         # # #   #     # #               #   #   # #   # #     #   # #
# ### ##### ### ##### ##### # ### ##### # # ##### ##### # # ### # ####### ### # # ### # # ##### ### #
#   #       #         #   # #   # #   # # #       #     #   # # # #       #   # #   # # # #         #
# ### ##### # ##### ### ### ##### ### # # ####### # ### # # # # # ####### ### ### ### # # ##### ### #
# #   # # # # #   # #               # # #       # # # # # # #   #       # # # #   #   #       #   # #
# # ### # # # # # # ######### ### ### # ##### ### ### ### # ####### ### # # # ### # # ####### ### # #
# # #     # # # # #       #   # #     #     # #           #         #   # #     # #    ##   #   # # #
# # # ### ### # ### ##### ### # ####### ##### ### ### ##### #   ### ### # ##### # ####### # ##  # # #
# # #         #     #   #   # #   #     #       # #   #     #   # #   # #     # #      ## #     # # #
# # ##### # ### # ### # ### # ### # ### ######### ### # ### # ### ### # ##### # # ### ### ### # ### #
# #     #   #   # #       #     # # # #             # #   # # #     # #     # # # #   ##    # #     #
# ### # ### ### # # ### ### ##### ### ##### ####### # ### ### ### ### # ### # # # ### ##### ### ### #
#   #     # # # # #   # #   #   #           #     # #   #       #   # # # # # # #   #  #  #         #
# # ### ### # # # ##### # ### ### ########### ### # # ### ##### ### ### # # ### ### # ### ### #   # #
# #   # #     # #       #         #             # # # #   #       #     #         # # ### #   #   # #
# ### ### # ### ### ### ### ### # ### ### ####### # # # # # # ### ### # ######### ### ### ### ### # #
#   #       #     # # #   # # # #   # # # # #     # # # #   # #     # #     #   #     ###           #
# # # ### ### ### # # # ### # ### ### # ### # ##### ### ##### # ### # # ### # ### ########### ### ###
# # # # # #   # # # #   #         #           #               # # #     # #            #  # #     # #
# # # # ### ### ### # ### ##### # ### ### # ################# ### # # ### ### # ###   ##### # ### # #
# # # #   # #       # #         #   # # # # #         #     #     # # # # # # # #     ###   # # # # #
# # # # ### # ### ### ##### ######### # ### # ### # ####### ### ### # # # # # # ##### ### ### # ##  #
# # # #       # # #       # #     #   #   # # # # # #         # # # # #   # # #     # ##  #         #
# # ### ####### ### ##### ### ### ### ### # ### # ### ### # # ### # # ### # # ####### ### # ### ##  #
# #     #             #       # #       #       #     # # # #     # #   # # #          ## #   #     #
# # ##### ### ####### ##### ### # # ### ### # ### ### # ### # ### # # ### # ##### ####### ### ###   #
# # #       # #     #     # #   # # # #   # # # # # # #     # # # #   #   #     # #   ##    #   #   #
# # ### ### ### ### ### ### # # ### # # ### ### ### # # ### ### # ### # ##### # # ### ###########  ##
# # # # # #     # #   # #   # #     #   #   #         # # #     #   # #     # # #   #  ##           #
# # # # # ####### # # # ##### ##### ### ##### ### ##### # ##### ### ### ### ### ### ### ####### ### #
# # #   #         # #     #           #         # #               #     # #       #     #     # #   #
# # ### # ### ### # # ### ##### ### ### ### ### # ##### ### ########### # ### ### # ##### ### ###   #
#     # #     #   # # # #       # #   # # # #   #     # # # #         #     # # # # #   #           #
# ### # ##### # ### # # # ##### # ### # # ### # ### # ### # ### ### ### ### ### # ### ### ########  #
#   # #         #   # # #     #     #   # #   # # # #     #     # # #   # #     # #     # #         #
# ### ### ### ##### ### # ### ### ### # # ##### # ##### # # # ### ### ### ### ### # ##### ### ####  #
# #     #   # #           # #   # #   # #       #     #   # # #       #     # #     #   ##  #       #
# ### # ### ### ### ####### # # ### ##### ### ### ### # # ### ##### ### ### # # ### ### ### ######  #
#   # #   #     # # #       # #               #       # #         # #   #   # # # #   # ###         #
# ### # ### ### # # ### ##### ### ### ######### ##### # ### ####### ### ##### ### ### # ##########  #
# #     #   #   #     # #     # #   #     #     #   # #     #         #         #   # # ##          #
# ####### ##### # ##### # ### # ##### ##### ### ### # ##### ### ### ##### ####### ##### ####### ##  #
#     #         # #     #   #         #     # # # # #   # #   # # #       #       #     ###   # #   #
# ##### ####### ### ### ### ###   ### # # ### # # # # ### ### ### ####### # ### ### ##### # # # ##  #
#       #   # #     # #   #       # # # # #   # # #   #     #           # # #   #   #     # # #     #
# ##### ### # ####### ### ### ### # ##### # ### # ##### ### ######### # # # ##### ### ##### # ####  #
# #   #               #       # # #       # #                       # # # #       #       # #       #
# # # ### ####### ### # ### # # # ##### ### # ####### # ### ### ### ### ### # ##### ####### ### ## ##
# #     # #     # #   # # # #   #     # #   #   # #   # # #     # # #       # #     #     # #   #   #
# ### ### # ### # # ### # # ##### ### ### ### ### ### ### ####### # # ####### ### # ### ### ### ##  #
#   #     # # # # # #   # #       # #     #   #                   # # #         # #   #   #         #
#   # ### # # # ### # ### # ##### # # ### # ### # ####### # ##### # # ### ##### # ### ##### #####  ##
#   # # # # # #   # # #     #   # # # #   # # # # #     # #       #     # #   # #   # #   # #   #   #
# # # # # # # ##### # ### ### # ### # ##### # ### # ### # # ##### # ### # # ### ### ### ### ### #   #
# #   #   #         #   # #   #       #           # #   # # #   # #   # # # #   # #     # #   # #   #
# ##### ### ##### ### # # ### ### ##### ### ####### # ##### ### # ##### ### ### # ### ### # # # #   #
#       #   #   # #   # # #       #     #   #       # #       # #                   #     # # #     #
# ##### # # ### # ##### # ##### ### ### # ##### ##### ######### ### ####### ### ### ##### ### ###   #
# #   # # #     #       #     #     # # # #     #                 # #     # #   # #     # ##    #   #
# # ### ### ### # ######### # ### ### ### # ### ####### ##### ### ### ### ### ### # ##### ##### ##  #
#   #     # # # # #       # #   #   #     # # #     #   #   # #       # #           #      #  #     #
# ##### ### # # ### ### # # ### # ### ##### # ##### # ### # # # ### ### ### ##### ### ### ### ####  #
#     # # # # #       # # #   # # #   #         # # # #   # # # # # #     #       #   #    #  #     #
# ##### # # # ### ### ### # # # # # # ### ##### # ### ### ### ### # ### ### ##### # ### # ##### ##  #
# #     # # #   # # #     # # # # # #   # #   # #       #         #   #     #   # # #   # ##    #   #
# # ### # ### ### # # ### ### ### # ##### # ### ####### ### ##### ### # ### # ### # # # ######### # #
# # # #       #   # # # #         #     # # #         #   #       # #     # #       # #    #    # # #
# # # ####### ### # ### ### ####### ### ### # ### ### ### ####### # ####### # ##### # # ##### # # # #
# # #       #   # #     # # # #     # # # #   # # # #   #       # #         # #     # #   ### # # # #
# # # ### ### ### # ### # ### # ### # # # # ### ### # # # ####### ##### ##### ####### ### ####### # #
# # #   # #   #   # # #       # # # # # #   #       # # #             # #               # ##      # #
# # ### ### # # ### # # ##### # # # # # # ##### # ### # ### ######### # ########### ##### ### ## ## #
# #   #     # # #   #   #   # # # # #   # #     # #       # #       #               #      #  #     #
# ### ##### ### # # ##### # # ### ### ### # ##### ### ##### ##### ### ### ### ### ### ####### ##  # #
#         #   # #         # #     #   # # #           #         # #   # # # # # # #   # #  ##     # #
# # ### # ### ### ####### # ##### ##### # ######### ### ### ### # ### # ### ### # ##### #######   # #
# # # # # #       #     # #     #       #         # #   # # # # #   #           #          ##   # # #
# # # ### ######### ##### ### ### ### ### # # ### # ##### ### # ### ### ##### ### ########### # # # #
# # #                       # #       #   # #   # #           #   # #   #     #   #        #  # # # #
# # # ##### ########### # ### # ####### ##### ### ### ####### # ### ##### ##### # ### ### ##### ### #
#   # #   # #         #   #   # #       #     #       #     # # #         #     #     # # # #       #
# ### # ### # ### # # # ### # # ### # ### ##### ####### ##### # ########### ##### ### # ### # ##### #
#   # # #   # # # # # #     # #   # # #   #             #     #             #   # # #       # #     #
# # ### ### # # # # ### ### # ##### # ### ############# # ### # ### ### ##### # ### ####### ### ### #
# #       # # # # #     #   #       #   #           #   # # # # #   # # #     #     #     # #   #x# #
# ######### ### ### ### ##### ##### ##### ######### ### ### ### # ### ####### ####### ### ####### # #
#                                                 #   #                               #     #       #
#####################################################################################################
