0               #   
                #   
   ###          #   
#### ###       ##   
     # ##       #   
     #  ##      #   
     #   ##     #   
     #    ##    #   
     #     ##   #   
     #      ##  #   
     #       ##     
     #        ###   
     #         ##   
     #              
     #              
     #              
     #              
     #              
     #              
     ##            x
