#############################################
# 0 #               #   #                 x #
#   #   #   #####   #   #   #############   #
#       #       #       #   #       #       #
#   #########   #########   #   #   #   #####
#           #           #   #   #   #   #   #
#   #################   #####   #   #   #   #
#   #           #       #       #       #   #
#   #   #####   #   #   #   #############   #
#   #   #           #   #       #           #
#   #   #####################   #####   #   #
#   #   #                   #           #   #
#####   #   #############   #############   #
#       #   #           #                   #
#   #####   #########   #####################
#                                           #
#############################################